1 1 1 1 1 1 1 1 1 1 1 1 1 1 1 1 1 1 1 1 1 1 1 1 1 1 1 1 1 1 1 1 1 1 1 1 1 1 1 1 1 1 1 1 1 1 1 1 1 1 2 2 2 2 2 2 2 2 2 2 2 2 2 2 2 2 2 2 2 2 2 2 2 2 2 2 2 2 2 2 2 2 2 2 2 2 2 2 2 2 2 2 2 2 2 2 2 2 2 2 
1 1 1 1 1 1 1 1 1 1 1 1 1 1 1 1 1 1 1 1 1 1 1 1 1 1 1 1 1 1 1 1 1 1 1 1 1 1 1 1 1 1 1 1 1 1 1 1 1 1 2 2 2 2 2 2 2 2 2 2 2 2 2 2 2 2 2 2 2 2 2 2 2 2 2 2 2 2 2 2 2 2 2 2 2 2 2 2 2 2 2 2 2 2 2 2 2 2 2 2 
1 1 3 3 1 1 3 3 3 3 3 3 1 1 3 3 3 3 3 3 1 1 3 3 3 3 3 3 3 3 3 3 3 3 3 3 3 3 3 3 3 3 3 3 3 3 3 3 1 1 2 2 5 5 5 5 5 5 2 2 5 5 5 5 5 5 2 2 5 5 5 5 5 5 5 5 5 5 5 5 5 5 5 5 5 5 2 2 5 5 5 5 5 5 2 2 5 5 2 2 
1 1 3 3 1 1 3 3 3 3 3 3 1 1 3 3 3 3 3 3 1 1 3 3 3 3 3 3 3 3 3 3 3 3 3 3 3 3 3 3 3 3 3 3 3 3 3 3 1 1 2 2 5 5 5 5 5 5 2 2 5 5 5 5 5 5 2 2 5 5 5 5 5 5 5 5 5 5 5 5 5 5 5 5 5 5 2 2 5 5 5 5 5 5 2 2 5 5 2 2 
1 1 3 3 1 1 3 3 1 1 3 3 1 1 3 3 1 1 3 3 1 1 1 1 1 1 3 3 1 1 1 1 1 1 1 1 1 1 1 1 1 1 3 3 1 1 1 1 1 1 2 2 2 2 2 2 5 5 2 2 5 5 2 2 5 5 2 2 2 2 2 2 2 2 2 2 5 5 2 2 2 2 2 2 5 5 2 2 5 5 2 2 5 5 2 2 5 5 2 2 
1 1 3 3 1 1 3 3 1 1 3 3 1 1 3 3 1 1 3 3 1 1 1 1 1 1 3 3 1 1 1 1 1 1 1 1 1 1 1 1 1 1 3 3 1 1 1 1 1 1 2 2 2 2 2 2 5 5 2 2 5 5 2 2 5 5 2 2 2 2 2 2 2 2 2 2 5 5 2 2 2 2 2 2 5 5 2 2 5 5 2 2 5 5 2 2 5 5 2 2 
1 1 3 3 1 1 3 3 1 1 3 3 3 3 3 3 1 1 3 3 3 3 3 3 1 1 3 3 3 3 3 3 1 1 3 3 3 3 3 3 1 1 3 3 3 3 3 3 1 1 2 2 5 5 2 2 5 5 2 2 5 5 2 2 5 5 5 5 5 5 5 5 5 5 2 2 5 5 5 5 5 5 2 2 5 5 5 5 5 5 2 2 5 5 5 5 5 5 2 2 
1 1 3 3 1 1 3 3 1 1 3 3 3 3 3 3 1 1 3 3 3 3 3 3 1 1 3 3 3 3 3 3 1 1 3 3 3 3 3 3 1 1 3 3 3 3 3 3 1 1 2 2 5 5 2 2 5 5 2 2 5 5 2 2 5 5 5 5 5 5 5 5 5 5 2 2 5 5 5 5 5 5 2 2 5 5 5 5 5 5 2 2 5 5 5 5 5 5 2 2 
1 1 3 3 1 1 3 3 1 1 1 1 1 1 1 1 1 1 1 1 1 1 3 3 1 1 1 1 1 1 3 3 1 1 3 3 1 1 1 1 1 1 1 1 1 1 3 3 1 1 2 2 5 5 2 2 5 5 2 2 5 5 2 2 2 2 2 2 2 2 2 2 5 5 2 2 2 2 2 2 5 5 2 2 2 2 2 2 2 2 2 2 2 2 2 2 5 5 2 2 
1 1 3 3 1 1 3 3 1 1 1 1 1 1 1 1 1 1 1 1 1 1 3 3 1 1 1 1 1 1 3 3 1 1 3 3 1 1 1 1 1 1 1 1 1 1 3 3 1 1 2 2 5 5 2 2 5 5 2 2 5 5 2 2 2 2 2 2 2 2 2 2 5 5 2 2 2 2 2 2 5 5 2 2 2 2 2 2 2 2 2 2 2 2 2 2 5 5 2 2 
1 1 3 3 3 3 3 3 1 1 3 3 3 3 3 3 3 3 3 3 1 1 3 3 1 1 3 3 1 1 3 3 3 3 3 3 1 1 3 3 3 3 3 3 3 3 3 3 1 1 2 2 5 5 2 2 5 5 2 2 5 5 2 2 5 5 5 5 5 5 2 2 5 5 2 2 5 5 5 5 5 5 2 2 5 5 5 5 5 5 5 5 5 5 5 5 5 5 2 2 
1 1 3 3 3 3 3 3 1 1 3 3 3 3 3 3 3 3 3 3 1 1 3 3 1 1 3 3 1 1 3 3 3 3 3 3 1 1 3 3 3 3 3 3 3 3 3 3 1 1 2 2 5 5 2 2 5 5 2 2 5 5 2 2 5 5 5 5 5 5 2 2 5 5 2 2 5 5 5 5 5 5 2 2 5 5 5 5 5 5 5 5 5 5 5 5 5 5 2 2 
1 1 1 1 1 1 1 1 1 1 3 3 1 1 3 3 1 1 1 1 1 1 3 3 1 1 3 3 1 1 3 3 1 1 1 1 1 1 3 3 1 1 1 1 1 1 1 1 1 1 2 2 5 5 2 2 5 5 2 2 5 5 2 2 2 2 2 2 5 5 2 2 5 5 2 2 5 5 2 2 2 2 2 2 5 5 2 2 2 2 2 2 2 2 2 2 5 5 2 2 
1 1 1 1 1 1 1 1 1 1 3 3 1 1 3 3 1 1 1 1 1 1 3 3 1 1 3 3 1 1 3 3 1 1 1 1 1 1 3 3 1 1 1 1 1 1 1 1 1 1 2 2 5 5 2 2 5 5 2 2 5 5 2 2 2 2 2 2 5 5 2 2 5 5 2 2 5 5 2 2 2 2 2 2 5 5 2 2 2 2 2 2 2 2 2 2 5 5 2 2 
1 1 3 3 3 3 3 3 1 1 3 3 1 1 3 3 3 3 3 3 3 3 3 3 1 1 3 3 3 3 3 3 1 1 3 3 3 3 3 3 1 1 3 3 3 3 3 3 1 1 2 2 5 5 2 2 5 5 5 5 5 5 2 2 5 5 5 5 5 5 2 2 5 5 2 2 5 5 2 2 5 5 5 5 5 5 2 2 5 5 5 5 5 5 2 2 5 5 2 2 
1 1 3 3 3 3 3 3 1 1 3 3 1 1 3 3 3 3 3 3 3 3 3 3 1 1 3 3 3 3 3 3 1 1 3 3 3 3 3 3 1 1 3 3 3 3 3 3 1 1 2 2 5 5 2 2 5 5 5 5 5 5 2 2 5 5 5 5 5 5 2 2 5 5 2 2 5 5 2 2 5 5 5 5 5 5 2 2 5 5 5 5 5 5 2 2 5 5 2 2 
1 1 1 1 1 1 3 3 1 1 3 3 1 1 1 1 1 1 1 1 1 1 1 3 1 1 1 1 1 1 1 1 1 1 3 3 1 1 3 3 1 1 3 3 1 1 3 3 1 1 2 2 5 5 2 2 2 2 2 2 2 2 2 2 5 5 2 2 5 5 2 2 5 5 2 2 5 5 2 2 2 2 2 2 2 2 2 2 5 5 2 2 5 5 2 2 2 2 2 2 
1 1 1 1 1 1 3 3 1 1 3 3 1 1 1 1 1 1 1 1 1 1 1 3 1 1 1 1 1 1 1 1 1 1 3 3 1 1 3 3 1 1 3 3 1 1 3 3 1 1 2 2 5 5 2 2 2 2 2 2 2 2 2 2 5 5 2 2 5 5 2 2 5 5 2 2 5 5 2 2 2 2 2 2 2 2 2 2 5 5 2 2 5 5 2 2 2 2 2 2 
1 1 3 3 3 3 3 3 1 1 3 3 1 1 3 3 1 1 0 0 0 0 0 0 0 0 0 0 0 0 0 0 1 1 3 3 1 1 3 3 1 1 3 3 1 1 3 3 1 1 2 2 5 5 5 5 5 5 5 5 5 5 2 2 5 5 2 2 5 5 2 2 5 5 2 2 5 5 5 5 5 5 5 5 5 5 2 2 5 5 2 2 5 5 5 5 5 5 2 2 
1 1 3 3 3 3 3 3 1 1 3 3 1 1 3 3 1 1 0 0 0 0 0 0 0 0 0 0 0 0 0 0 1 1 3 3 1 1 3 3 1 1 3 3 1 1 3 3 1 1 2 2 5 5 5 5 5 5 5 5 5 5 2 2 5 5 2 2 5 5 2 2 5 5 2 2 5 5 5 5 5 5 5 5 5 5 2 2 5 5 2 2 5 5 5 5 5 5 2 2 
1 1 3 3 1 1 3 3 1 1 3 3 1 1 3 3 1 1 0 0 0 0 0 0 0 0 0 0 0 0 0 0 1 1 3 3 1 1 1 1 1 1 3 3 1 1 3 3 1 1 2 2 5 5 2 2 5 5 2 2 5 5 2 2 5 5 2 2 5 5 2 2 5 5 2 2 5 5 2 2 2 2 2 2 5 5 2 2 5 5 2 2 2 2 2 2 5 5 2 2 
1 1 3 3 1 1 3 3 1 1 3 3 1 1 3 3 1 1 0 0 0 0 0 0 0 0 0 0 0 0 0 0 1 1 3 3 1 1 1 1 1 1 3 3 1 1 3 3 1 1 2 2 5 5 2 2 5 5 2 2 5 5 2 2 5 5 2 2 5 5 2 2 5 5 2 2 5 5 2 2 2 2 2 2 5 5 2 2 5 5 2 2 2 2 2 2 5 5 2 2 
1 1 3 3 1 1 3 3 1 1 3 3 3 3 3 3 1 1 0 0 0 0 0 0 0 0 0 0 0 0 0 0 1 1 3 3 1 1 3 3 3 3 3 3 1 1 3 3 1 1 2 2 5 5 2 2 5 5 2 2 5 5 5 5 5 5 2 2 5 5 2 2 5 5 2 2 5 5 2 2 5 5 2 2 5 5 2 2 5 5 2 2 5 5 2 2 5 5 2 2 
1 1 3 3 1 1 3 3 1 1 3 3 3 3 3 3 1 1 0 0 0 0 0 0 0 0 0 0 0 0 0 0 1 1 3 3 1 1 3 3 3 3 3 3 1 1 3 3 1 1 2 2 5 5 2 2 5 5 2 2 5 5 5 5 5 5 2 2 5 5 2 2 5 5 2 2 5 5 2 2 5 5 2 2 5 5 2 2 5 5 2 2 5 5 2 2 5 5 2 2 
1 1 3 3 1 1 3 3 1 1 1 1 1 1 3 3 1 1 0 0 0 0 0 0 0 0 0 0 0 0 0 0 1 1 3 3 1 1 3 3 1 1 1 1 1 1 3 3 1 1 2 2 5 5 2 2 5 5 2 2 2 2 2 2 5 5 2 2 2 2 2 2 5 5 2 2 5 5 2 2 5 5 2 2 5 5 2 2 5 5 2 2 5 5 2 2 5 5 2 2 
1 1 3 3 1 1 3 3 1 1 1 1 1 1 3 3 1 1 0 0 0 0 0 0 0 0 0 0 0 0 0 0 1 1 3 3 1 1 3 3 1 1 1 1 1 1 3 3 1 1 2 2 5 5 2 2 5 5 2 2 2 2 2 2 5 5 2 2 2 2 2 2 5 5 2 2 5 5 2 2 5 5 2 2 5 5 2 2 5 5 2 2 5 5 2 2 5 5 2 2 
1 1 3 3 1 1 3 3 3 3 3 3 1 1 3 3 1 1 0 0 0 0 0 0 0 0 0 0 0 0 0 0 1 1 3 3 3 3 3 3 3 3 3 3 1 1 3 3 1 1 2 2 5 5 2 2 5 5 2 2 5 5 2 2 5 5 2 2 5 5 5 5 5 5 2 2 5 5 2 2 5 5 2 2 5 5 5 5 5 5 2 2 5 5 2 2 5 5 2 2 
1 1 3 3 1 1 3 3 3 3 3 3 1 1 3 3 1 1 0 0 0 0 0 0 0 0 0 0 0 0 0 0 1 1 3 3 3 3 3 3 3 3 3 3 1 1 3 3 1 1 2 2 5 5 2 2 5 5 2 2 5 5 2 2 5 5 2 2 5 5 5 5 5 5 2 2 5 5 2 2 5 5 2 2 5 5 5 5 5 5 2 2 5 5 2 2 5 5 2 2 
1 1 3 3 1 1 1 1 1 1 1 1 1 1 3 3 1 1 0 0 0 0 0 0 0 0 0 0 0 0 0 0 1 1 3 3 1 1 1 1 1 1 1 1 1 1 3 3 1 1 2 2 2 2 2 2 5 5 2 2 5 5 2 2 5 5 2 2 5 5 2 2 2 2 2 2 5 5 2 2 5 5 2 2 2 2 2 2 2 2 2 2 5 5 2 2 5 5 2 2 
1 1 3 3 1 1 1 1 1 1 1 1 1 1 3 3 1 1 0 0 0 0 0 0 0 0 0 0 0 0 0 0 1 1 3 3 1 1 1 1 1 1 1 1 1 1 3 3 1 1 2 2 2 2 2 2 5 5 2 2 5 5 2 2 5 5 2 2 5 5 2 2 2 2 2 2 5 5 2 2 5 5 2 2 2 2 2 2 2 2 2 2 5 5 2 2 5 5 2 2 
1 1 3 3 3 3 3 3 1 1 3 3 3 3 3 3 1 1 0 0 0 0 0 0 0 0 0 0 0 0 0 0 1 1 3 3 1 1 3 3 1 1 3 3 3 3 3 3 1 1 2 2 5 5 5 5 5 5 2 2 5 5 5 5 5 5 2 2 5 5 5 5 5 5 2 2 5 5 5 5 5 5 5 5 5 5 5 5 5 5 5 5 5 5 2 2 5 5 2 2 
1 1 3 3 3 3 3 3 1 1 3 3 3 3 3 3 1 1 0 0 0 0 0 0 0 0 0 0 0 0 0 0 1 1 3 3 1 1 3 3 1 1 3 3 3 3 3 3 1 1 2 2 5 5 5 5 5 5 2 2 5 5 5 5 5 5 2 2 5 5 5 5 5 5 2 2 5 5 5 5 5 5 5 5 5 5 5 5 5 5 5 5 5 5 2 2 5 5 2 2 
1 1 1 1 1 1 3 3 1 1 3 3 1 1 1 1 1 1 1 1 1 1 1 1 1 1 1 1 1 1 1 1 1 1 3 3 1 1 3 3 1 1 3 3 1 1 1 1 1 1 2 2 5 5 2 2 2 2 2 2 5 5 2 2 2 2 2 2 2 2 2 2 5 5 2 2 2 2 2 2 2 2 2 2 2 2 2 2 2 2 2 2 2 2 2 2 5 5 2 2 
1 1 1 1 1 1 3 3 1 1 3 3 1 1 1 1 1 1 1 1 1 1 1 1 1 1 1 1 1 1 1 1 1 1 3 3 1 1 3 3 1 1 3 3 1 1 1 1 1 1 2 2 5 5 2 2 2 2 2 2 5 5 2 2 2 2 2 2 2 2 2 2 5 5 2 2 2 2 2 2 2 2 2 2 2 2 2 2 2 2 2 2 2 2 2 2 5 5 2 2 
1 1 3 3 3 3 3 3 1 1 3 3 3 3 3 3 1 1 3 3 3 3 3 3 3 3 3 3 1 1 3 3 3 3 3 3 1 1 3 3 1 1 3 3 3 3 3 3 1 1 2 2 5 5 2 2 5 5 5 5 5 5 5 5 5 5 2 2 5 5 2 2 5 5 5 5 5 5 2 2 5 5 5 5 5 5 2 2 5 5 5 5 5 5 5 5 5 5 2 2 
1 1 3 3 3 3 3 3 1 1 3 3 3 3 3 3 1 1 3 3 3 3 3 3 3 3 3 3 1 1 3 3 3 3 3 3 1 1 3 3 1 1 3 3 3 3 3 3 1 1 2 2 5 5 2 2 5 5 5 5 5 5 5 5 5 5 2 2 5 5 2 2 5 5 5 5 5 5 2 2 5 5 5 5 5 5 2 2 5 5 5 5 5 5 5 5 5 5 2 2 
1 1 3 3 1 1 1 1 1 1 1 1 1 1 3 3 1 1 3 3 1 1 1 1 1 1 1 1 1 1 3 3 1 1 1 1 1 1 3 3 1 1 1 1 1 1 3 3 1 1 2 2 5 5 2 2 2 2 2 2 2 2 2 2 5 5 2 2 5 5 2 2 2 2 2 2 5 5 2 2 5 5 2 2 5 5 2 2 5 5 2 2 2 2 2 2 5 5 2 2 
1 1 3 3 1 1 1 1 1 1 1 1 1 1 3 3 1 1 3 3 1 1 1 1 1 1 1 1 1 1 3 3 1 1 1 1 1 1 3 3 1 1 1 1 1 1 3 3 1 1 2 2 5 5 2 2 2 2 2 2 2 2 2 2 5 5 2 2 5 5 2 2 2 2 2 2 5 5 2 2 5 5 2 2 5 5 2 2 5 5 2 2 2 2 2 2 5 5 2 2 
1 1 3 3 3 3 3 3 3 3 3 3 3 3 3 3 1 1 3 3 3 3 3 3 3 3 3 3 1 1 3 3 3 3 3 3 3 3 3 3 1 1 3 3 1 1 3 3 1 1 2 2 5 5 5 5 5 5 2 2 5 5 5 5 5 5 5 5 5 5 5 5 5 5 2 2 5 5 5 5 5 5 2 2 5 5 2 2 5 5 2 2 5 5 5 5 5 5 2 2 
1 1 3 3 3 3 3 3 3 3 3 3 3 3 3 3 1 1 3 3 3 3 3 3 3 3 3 3 1 1 3 3 3 3 3 3 3 3 3 3 1 1 3 3 1 1 3 3 1 1 2 2 5 5 5 5 5 5 2 2 5 5 5 5 5 5 5 5 5 5 5 5 5 5 2 2 5 5 5 5 5 5 2 2 5 5 2 2 5 5 2 2 5 5 5 5 5 5 2 2 
1 1 3 3 1 1 1 1 1 1 1 1 1 1 1 1 1 1 1 1 1 1 1 1 1 1 3 3 1 1 1 1 1 1 1 1 1 1 3 3 1 1 3 3 1 1 3 3 1 1 2 2 5 5 2 2 5 5 2 2 2 2 2 2 2 2 2 2 2 2 2 2 2 2 2 2 2 2 2 2 2 2 2 2 5 5 2 2 5 5 2 2 5 5 2 2 2 2 2 2 
1 1 3 3 1 1 1 1 1 1 1 1 1 1 1 1 1 1 1 1 1 1 1 1 1 1 3 3 1 1 1 1 1 1 1 1 1 1 3 3 1 1 3 3 1 1 3 3 1 1 2 2 5 5 2 2 5 5 2 2 2 2 2 2 2 2 2 2 2 2 2 2 2 2 2 2 2 2 2 2 2 2 2 2 5 5 2 2 5 5 2 2 5 5 2 2 2 2 2 2 
1 1 3 3 3 3 3 3 3 3 3 3 1 1 3 3 3 3 3 3 3 3 3 3 1 1 3 3 3 3 3 3 3 3 3 3 3 3 3 3 3 3 3 3 1 1 3 3 1 1 2 2 5 5 2 2 5 5 5 5 5 5 5 5 5 5 2 2 5 5 5 5 5 5 5 5 5 5 2 2 5 5 5 5 5 5 2 2 5 5 2 2 5 5 2 2 5 5 2 2 
1 1 3 3 3 3 3 3 3 3 3 3 1 1 3 3 3 3 3 3 3 3 3 3 1 1 3 3 3 3 3 3 3 3 3 3 3 3 3 3 3 3 3 3 1 1 3 3 1 1 2 2 5 5 2 2 5 5 5 5 5 5 5 5 5 5 2 2 5 5 5 5 5 5 5 5 5 5 2 2 5 5 5 5 5 5 2 2 5 5 2 2 5 5 2 2 5 5 2 2 
1 1 1 1 1 1 1 1 1 1 3 3 1 1 3 3 1 1 1 1 1 1 3 3 1 1 1 1 1 1 1 1 1 1 1 1 1 1 1 1 1 1 1 1 1 1 3 3 1 1 2 2 5 5 2 2 2 2 2 2 2 2 2 2 5 5 2 2 5 5 2 2 2 2 2 2 5 5 2 2 5 5 2 2 2 2 2 2 5 5 2 2 5 5 2 2 5 5 2 2 
1 1 1 1 1 1 1 1 1 1 3 3 1 1 3 3 1 1 1 1 1 1 3 3 1 1 1 1 1 1 1 1 1 1 1 1 1 1 1 1 1 1 1 1 1 1 3 3 1 1 2 2 5 5 2 2 2 2 2 2 2 2 2 2 5 5 2 2 5 5 2 2 2 2 2 2 5 5 2 2 5 5 2 2 2 2 2 2 5 5 2 2 5 5 2 2 5 5 2 2 
1 1 3 3 3 3 3 3 3 3 3 3 3 3 3 3 1 1 3 3 3 3 3 3 3 3 3 3 3 3 3 3 3 3 3 3 3 3 3 3 3 3 3 3 3 3 3 3 1 1 2 2 5 5 5 5 5 5 5 5 5 5 2 2 5 5 5 5 5 5 5 5 5 5 2 2 5 5 5 5 5 5 5 5 5 5 5 5 5 5 2 2 5 5 5 5 5 5 2 2 
1 1 3 3 3 3 3 3 3 3 3 3 3 3 3 3 1 1 3 3 3 3 3 3 3 3 3 3 3 3 3 3 3 3 3 3 3 3 3 3 3 3 3 3 3 3 3 3 1 1 2 2 5 5 5 5 5 5 5 5 5 5 2 2 5 5 5 5 5 5 5 5 5 5 2 2 5 5 5 5 5 5 5 5 5 5 5 5 5 5 2 2 5 5 5 5 5 5 2 2 
1 1 1 1 1 1 1 1 1 1 1 1 1 1 1 1 1 1 1 1 1 1 1 3 1 1 1 1 1 1 1 1 1 1 1 1 1 1 1 1 1 1 1 1 1 1 1 1 1 1 2 2 2 2 2 2 2 2 2 2 2 2 2 2 2 2 2 2 2 2 2 2 2 2 2 2 2 2 2 2 2 2 2 2 2 2 2 2 2 2 2 2 2 2 2 2 5 5 2 2 
1 1 1 1 1 1 1 1 1 1 1 1 1 1 1 1 1 1 1 1 1 1 1 3 1 1 1 1 1 1 1 1 1 1 1 1 1 1 1 1 1 1 1 1 1 1 1 1 1 1 2 2 2 2 2 2 2 2 2 2 2 2 2 2 2 2 2 2 2 2 2 2 2 2 2 2 2 2 2 2 2 2 2 2 2 2 2 2 2 2 2 2 2 2 2 2 5 5 2 2 
0 0 0 0 0 0 0 0 0 0 0 0 0 0 0 0 0 0 0 0 0 0 0 0 0 0 0 0 0 0 0 0 0 0 0 0 0 0 0 0 0 0 0 0 0 0 0 0 0 0 4 4 4 4 4 4 4 4 4 4 4 4 4 4 4 4 4 4 4 4 4 4 4 4 4 4 4 4 4 4 4 4 4 4 4 4 4 4 4 4 4 4 4 4 4 4 0 0 4 4 
0 0 0 0 0 0 0 0 0 0 0 0 0 0 0 0 0 0 0 0 0 0 8 5 9 0 0 0 0 0 0 0 0 0 0 0 0 0 0 0 0 0 0 0 0 0 0 0 0 0 4 4 4 4 4 4 4 4 4 4 4 4 4 4 4 4 4 4 4 4 4 4 4 4 4 4 4 4 4 4 4 4 4 4 4 4 4 4 4 4 4 4 4 4 4 4 0 0 4 4 
0 0 0 0 0 0 0 0 0 0 0 0 0 0 0 0 0 0 0 0 0 4 8 5 9 0 0 0 0 0 0 0 0 0 0 0 0 0 0 0 0 0 0 0 0 0 0 0 0 0 4 4 0 0 0 0 0 0 4 4 0 0 4 4 0 0 0 0 0 0 0 0 0 0 0 0 0 0 0 0 0 0 0 0 0 0 4 4 0 0 0 0 0 0 0 0 0 0 4 4 
0 0 0 0 0 0 0 0 0 0 0 0 0 0 0 0 0 0 0 0 0 0 8 5 9 0 0 0 0 0 0 0 0 0 0 0 0 0 0 0 0 0 0 0 0 0 0 0 0 0 4 4 0 0 0 0 0 0 4 4 0 0 4 4 0 0 0 0 0 0 0 0 0 0 0 0 0 0 0 0 0 0 0 0 0 0 4 4 0 0 0 0 0 0 0 0 0 0 4 4 
0 0 0 0 0 0 0 0 0 0 0 0 0 0 0 0 0 0 0 0 0 4 8 5 9 0 0 0 0 0 0 0 0 0 0 0 0 0 0 0 0 0 0 0 0 0 0 0 0 0 4 4 4 4 4 4 0 0 4 4 0 0 4 4 0 0 4 4 4 4 4 4 0 0 4 4 4 4 4 4 4 4 4 4 0 0 4 4 0 0 4 4 4 4 4 4 0 0 4 4 
0 0 0 0 0 0 0 0 0 0 0 0 0 0 0 0 0 0 0 0 0 0 8 5 9 0 0 0 0 0 0 0 0 0 0 0 0 0 0 0 0 0 0 0 0 0 0 0 0 0 4 4 4 4 4 4 0 0 4 4 0 0 4 4 0 0 4 4 4 4 4 4 0 0 4 4 4 4 4 4 4 4 4 4 0 0 4 4 0 0 4 4 4 4 4 4 0 0 4 4 
0 0 0 0 0 0 0 0 0 0 0 0 0 0 0 0 0 0 0 0 0 4 8 5 9 0 0 0 0 0 0 0 0 0 0 0 0 0 0 0 0 0 0 0 0 0 0 0 0 0 4 4 0 0 4 4 0 0 4 4 0 0 4 4 0 0 4 4 0 0 4 4 0 0 0 0 0 0 4 4 0 0 0 0 0 0 4 4 0 0 4 4 0 0 0 0 0 0 4 4 
0 0 0 0 0 0 0 0 0 0 0 0 0 0 0 0 0 0 0 0 0 0 8 5 9 0 0 0 0 0 0 0 0 0 0 0 0 0 0 0 0 0 0 0 0 0 0 0 0 0 4 4 0 0 4 4 0 0 4 4 0 0 4 4 0 0 4 4 0 0 4 4 0 0 0 0 0 0 4 4 0 0 0 0 0 0 4 4 0 0 4 4 0 0 0 0 0 0 4 4 
0 0 0 0 0 0 0 0 0 0 0 0 0 0 0 0 0 0 0 0 0 4 8 5 9 0 0 0 0 0 0 0 0 0 0 0 0 0 0 0 0 0 0 0 0 0 0 0 0 0 4 4 0 0 4 4 0 0 4 4 0 0 4 4 0 0 4 4 0 0 4 4 4 4 4 4 0 0 4 4 4 4 4 4 0 0 4 4 0 0 4 4 0 0 4 4 4 4 4 4 
0 0 0 0 0 0 0 0 0 0 0 0 0 0 0 0 0 0 0 0 0 0 8 5 9 0 0 0 0 0 0 0 0 0 0 0 0 0 0 0 0 0 0 0 0 0 0 0 0 0 4 4 0 0 4 4 0 0 4 4 0 0 4 4 0 0 4 4 0 0 4 4 4 4 4 4 0 0 4 4 4 4 4 4 0 0 4 4 0 0 4 4 0 0 4 4 4 4 4 4 
0 0 0 0 0 0 0 0 0 0 0 0 0 0 0 0 0 0 0 0 0 4 8 5 9 0 0 0 0 0 0 0 0 0 0 0 0 0 0 0 0 0 0 0 0 0 0 0 0 0 4 4 0 0 4 4 0 0 4 4 0 0 4 4 0 0 0 0 0 0 4 4 0 0 4 4 0 0 0 0 0 0 4 4 0 0 4 4 0 0 4 4 0 0 0 0 0 0 4 4 
0 0 0 0 0 0 0 0 0 0 0 0 0 0 0 0 0 0 0 0 0 0 8 5 9 0 0 0 0 0 0 0 0 0 0 0 0 0 0 0 0 0 0 0 0 0 0 0 0 0 4 4 0 0 4 4 0 0 4 4 0 0 4 4 0 0 0 0 0 0 4 4 0 0 4 4 0 0 0 0 0 0 4 4 0 0 4 4 0 0 4 4 0 0 0 0 0 0 4 4 
0 0 0 0 0 0 0 0 0 0 0 0 0 0 0 0 0 0 0 0 0 4 8 5 9 0 0 0 0 0 0 0 0 0 0 0 0 0 0 0 0 0 0 0 0 0 0 0 0 0 4 4 0 0 4 4 0 0 4 4 0 0 4 4 4 4 4 4 0 0 4 4 0 0 4 4 4 4 4 4 0 0 4 4 4 4 4 4 0 0 4 4 4 4 4 4 0 0 4 4 
0 0 0 0 0 0 0 0 0 0 0 0 0 0 0 0 0 0 0 0 0 0 8 5 9 0 0 0 0 0 0 0 0 0 0 0 0 0 0 0 0 0 0 0 0 0 0 0 0 0 4 4 0 0 4 4 0 0 4 4 0 0 4 4 4 4 4 4 0 0 4 4 0 0 4 4 4 4 4 4 0 0 4 4 4 4 4 4 0 0 4 4 4 4 4 4 0 0 4 4 
0 0 0 0 0 0 0 0 0 0 0 0 0 0 0 0 0 0 0 0 0 4 8 5 9 0 0 0 0 0 0 0 0 0 0 0 0 0 0 0 0 0 0 0 0 0 0 0 0 0 4 4 0 0 4 4 0 0 4 4 0 0 0 0 0 0 4 4 0 0 4 4 0 0 0 0 0 0 4 4 0 0 0 0 0 0 0 0 0 0 0 0 0 0 4 4 0 0 4 4 
0 0 0 0 0 0 0 0 0 0 0 0 0 0 0 0 0 0 0 0 0 0 8 5 9 0 0 0 0 0 0 0 0 0 0 0 0 0 0 0 0 0 0 0 0 0 0 0 0 0 4 4 0 0 4 4 0 0 4 4 0 0 0 0 0 0 4 4 0 0 4 4 0 0 0 0 0 0 4 4 0 0 0 0 0 0 0 0 0 0 0 0 0 0 4 4 0 0 4 4 
0 0 0 0 0 0 0 0 0 0 0 0 0 0 0 0 0 0 0 0 0 4 8 5 9 0 0 0 0 0 0 0 0 0 0 0 0 0 0 0 0 0 0 0 0 0 0 0 0 0 4 4 0 0 4 4 0 0 4 4 0 0 4 4 4 4 4 4 0 0 4 4 0 0 4 4 4 4 4 4 4 4 4 4 4 4 4 4 4 4 4 4 4 4 4 4 0 0 4 4 
0 0 0 0 0 0 0 0 0 0 0 0 0 0 0 0 0 0 0 0 0 0 8 5 9 0 0 0 0 0 0 0 0 0 0 0 0 0 0 0 0 0 0 0 0 0 0 0 0 0 4 4 0 0 4 4 0 0 4 4 0 0 4 4 4 4 4 4 0 0 4 4 0 0 4 4 4 4 4 4 4 4 4 4 4 4 4 4 4 4 4 4 4 4 4 4 0 0 4 4 
0 0 0 0 0 0 0 0 0 0 0 0 0 0 0 0 0 0 0 0 0 4 8 5 9 0 0 0 0 0 0 0 0 0 0 0 0 0 0 0 0 0 0 0 0 0 0 0 0 0 4 4 0 0 4 4 0 0 4 4 0 0 0 0 0 0 0 0 0 0 0 0 0 0 4 4 0 0 0 0 0 0 4 4 0 0 0 0 0 0 0 0 0 0 4 4 0 0 4 4 
0 0 0 0 0 0 0 0 0 0 0 0 0 0 0 0 0 0 0 0 0 0 8 5 9 0 0 0 0 0 0 0 0 0 0 0 0 0 0 0 0 0 0 0 0 0 0 0 0 0 4 4 0 0 4 4 0 0 4 4 0 0 0 0 0 0 0 0 0 0 0 0 0 0 4 4 0 0 0 0 0 0 4 4 0 0 0 0 0 0 0 0 0 0 4 4 0 0 4 4 
0 0 0 0 0 0 0 0 0 0 0 0 0 0 0 0 0 0 0 0 0 4 8 5 9 0 0 0 0 0 0 0 0 0 0 0 0 0 0 0 0 0 0 0 0 0 0 0 0 0 4 4 0 0 4 4 0 0 4 4 0 0 4 4 4 4 4 4 4 4 4 4 4 4 4 4 0 0 4 4 0 0 4 4 0 0 4 4 4 4 4 4 0 0 4 4 0 0 4 4 
0 0 0 0 0 0 0 0 0 0 0 0 0 0 0 0 0 0 0 0 0 0 8 5 11 6 6 6 6 6 6 6 6 6 6 6 6 6 6 6 6 6 6 6 6 6 6 6 6 0 4 4 0 0 4 4 0 0 4 4 0 0 4 4 4 4 4 4 4 4 4 4 4 4 4 4 0 0 4 4 0 0 4 4 0 0 4 4 4 4 4 4 0 0 4 4 0 0 4 4 
0 0 0 0 0 0 0 0 0 0 0 0 0 0 0 0 0 0 0 0 0 4 8 5 5 5 5 5 5 5 5 5 5 5 5 5 5 5 5 5 5 5 5 5 5 5 5 5 5 0 0 0 0 0 4 4 0 0 4 4 0 0 4 4 0 0 0 0 0 0 0 0 0 0 4 4 0 0 4 4 0 0 0 0 0 0 4 4 0 0 0 0 0 0 4 4 0 0 4 4 
0 0 0 0 0 0 0 0 0 0 0 0 0 0 0 0 0 0 0 0 0 0 10 7 7 7 7 7 7 7 7 7 7 7 7 7 7 7 7 7 7 7 7 7 7 7 7 7 7 0 0 0 0 0 4 4 0 0 4 4 0 0 4 4 0 0 0 0 0 0 0 0 0 0 4 4 0 0 4 4 0 0 0 0 0 0 4 4 0 0 0 0 0 0 4 4 0 0 4 4 
0 0 0 0 0 0 0 0 0 0 0 0 0 0 0 0 0 0 0 0 0 4 0 0 4 0 4 0 4 0 4 0 4 0 4 0 4 0 4 0 4 0 4 0 4 0 4 0 4 0 4 4 0 0 4 4 0 0 4 4 0 0 4 4 0 0 4 4 4 4 4 4 0 0 4 4 0 0 4 4 4 4 4 4 4 4 4 4 0 0 4 4 4 4 4 4 0 0 4 4 
0 0 0 0 0 0 0 0 0 0 0 0 0 0 0 0 0 0 0 0 0 0 0 0 0 0 0 0 0 0 0 0 0 0 0 0 0 0 0 0 0 0 0 0 0 0 0 0 0 0 4 4 0 0 4 4 0 0 4 4 0 0 4 4 0 0 4 4 4 4 4 4 0 0 4 4 0 0 4 4 4 4 4 4 4 4 4 4 0 0 4 4 4 4 4 4 0 0 4 4 
0 0 0 0 0 0 0 0 0 0 0 0 0 0 0 0 0 0 0 0 0 0 0 0 0 0 0 0 0 0 0 0 0 0 0 0 0 0 0 0 0 0 0 0 0 0 0 0 0 0 4 4 0 0 0 0 0 0 4 4 0 0 4 4 0 0 4 4 0 0 4 4 0 0 0 0 0 0 4 4 0 0 4 4 0 0 0 0 0 0 4 4 0 0 0 0 0 0 4 4 
0 0 0 0 0 0 0 0 0 0 0 0 0 0 0 0 0 0 0 0 0 0 0 0 0 0 0 0 0 0 0 0 0 0 0 0 0 0 0 0 0 0 0 0 0 0 0 0 0 0 4 4 0 0 0 0 0 0 4 4 0 0 4 4 0 0 4 4 0 0 4 4 0 0 0 0 0 0 4 4 0 0 4 4 0 0 0 0 0 0 4 4 0 0 0 0 0 0 4 4 
0 0 0 0 0 0 0 0 0 0 0 0 0 0 0 0 0 0 0 0 0 0 0 0 0 0 0 0 0 0 0 0 0 0 0 0 0 0 0 0 0 0 0 0 0 0 0 0 0 0 4 4 0 0 4 4 4 4 4 4 4 4 4 4 0 0 4 4 0 0 4 4 4 4 4 4 4 4 4 4 0 0 4 4 0 0 4 4 4 4 4 4 0 0 4 4 4 4 4 4 
0 0 0 0 0 0 0 0 0 0 0 0 0 0 0 0 0 0 0 0 0 0 0 0 0 0 0 0 0 0 0 0 0 0 0 0 0 0 0 0 0 0 0 0 0 0 0 0 0 0 4 4 0 0 4 4 4 4 4 4 4 4 4 4 0 0 4 4 0 0 4 4 4 4 4 4 4 4 4 4 0 0 4 4 0 0 4 4 4 4 4 4 0 0 4 4 4 4 4 4 
0 0 0 0 0 0 0 0 0 0 0 0 0 0 0 0 0 0 0 0 0 0 0 0 0 0 0 0 0 0 0 0 0 0 0 0 0 0 0 0 0 0 0 0 0 0 0 0 0 0 4 4 0 0 4 4 0 0 0 0 0 0 0 0 0 0 4 4 0 0 4 4 0 0 0 0 0 0 0 0 0 0 4 4 0 0 0 0 0 0 4 4 0 0 0 0 0 0 4 4 
0 0 0 0 0 0 0 0 0 0 0 0 0 0 0 0 0 0 0 0 0 0 0 0 0 0 0 0 0 0 0 0 0 0 0 0 0 0 0 0 0 0 0 0 0 0 0 0 0 0 4 4 0 0 4 4 0 0 0 0 0 0 0 0 0 0 4 4 0 0 4 4 0 0 0 0 0 0 0 0 0 0 4 4 0 0 0 0 0 0 4 4 0 0 0 0 0 0 4 4 
0 0 0 0 0 0 0 0 0 0 0 0 0 0 0 0 0 0 0 0 0 0 0 0 0 0 0 0 0 0 0 0 0 0 0 0 0 0 0 0 0 0 0 0 0 0 0 0 0 0 4 4 0 0 4 4 0 0 4 4 0 0 4 4 4 4 4 4 0 0 4 4 0 0 4 4 0 0 4 4 0 0 4 4 4 4 4 4 0 0 4 4 4 4 4 4 0 0 4 4 
0 0 0 0 0 0 0 0 0 0 0 0 0 0 0 0 0 0 0 0 0 0 0 0 0 0 0 0 0 0 0 0 0 0 0 0 0 0 0 0 0 0 0 0 0 0 0 0 0 0 4 4 0 0 4 4 0 0 4 4 0 0 4 4 4 4 4 4 0 0 4 4 0 0 4 4 0 0 4 4 0 0 4 4 4 4 4 4 0 0 4 4 4 4 4 4 0 0 4 4 
0 0 0 0 0 0 0 0 0 0 0 0 0 0 0 0 0 0 0 0 0 0 0 0 0 0 0 0 0 0 0 0 0 0 0 0 0 0 0 0 0 0 0 0 0 0 0 0 0 0 4 4 0 0 4 4 0 0 4 4 0 0 0 0 0 0 4 4 0 0 0 0 0 0 4 4 0 0 4 4 0 0 4 4 0 0 4 4 0 0 0 0 0 0 4 4 0 0 4 4 
0 0 0 0 0 0 0 0 0 0 0 0 0 0 0 0 0 0 0 0 0 0 0 0 0 0 0 0 0 0 0 0 0 0 0 0 0 0 0 0 0 0 0 0 0 0 0 0 0 0 4 4 0 0 4 4 0 0 4 4 0 0 0 0 0 0 4 4 0 0 0 0 0 0 4 4 0 0 4 4 0 0 4 4 0 0 4 4 0 0 0 0 0 0 4 4 0 0 4 4 
0 0 0 0 0 0 0 0 0 0 0 0 0 0 0 0 0 0 0 0 0 0 0 0 0 0 0 0 0 0 0 0 0 0 0 0 0 0 0 0 0 0 0 0 0 0 0 0 0 0 4 4 0 0 4 4 4 4 4 4 4 4 4 4 0 0 4 4 0 0 4 4 4 4 4 4 0 0 4 4 0 0 4 4 0 0 4 4 4 4 4 4 0 0 4 4 0 0 4 4 
0 0 0 0 0 0 0 0 0 0 0 0 0 0 0 0 0 0 0 0 0 0 0 0 0 0 0 0 0 0 0 0 0 0 0 0 0 0 0 0 0 0 0 0 0 0 0 0 0 0 4 4 0 0 4 4 4 4 4 4 4 4 4 4 0 0 4 4 0 0 4 4 4 4 4 4 0 0 4 4 0 0 4 4 0 0 4 4 4 4 4 4 0 0 4 4 0 0 4 4 
0 0 0 0 0 0 0 0 0 0 0 0 0 0 0 0 0 0 0 0 0 0 0 0 0 0 0 0 0 0 0 0 0 0 0 0 0 0 0 0 0 0 0 0 0 0 0 0 0 0 4 4 0 0 0 0 0 0 0 0 0 0 0 0 0 0 4 4 0 0 4 4 0 0 0 0 0 0 4 4 0 0 0 0 0 0 4 4 0 0 0 0 0 0 4 4 0 0 4 4 
0 0 0 0 0 0 0 0 0 0 0 0 0 0 0 0 0 0 0 0 0 0 0 0 0 0 0 0 0 0 0 0 0 0 0 0 0 0 0 0 0 0 0 0 0 0 0 0 0 0 4 4 0 0 0 0 0 0 0 0 0 0 0 0 0 0 4 4 0 0 4 4 0 0 0 0 0 0 4 4 0 0 0 0 0 0 4 4 0 0 0 0 0 0 4 4 0 0 4 4 
0 0 0 0 0 0 0 0 0 0 0 0 0 0 0 0 0 0 0 0 0 0 0 0 0 0 0 0 0 0 0 0 0 0 0 0 0 0 0 0 0 0 0 0 0 0 0 0 0 0 4 4 4 4 4 4 4 4 4 4 4 4 4 4 4 4 4 4 4 4 4 4 0 0 4 4 4 4 4 4 4 4 4 4 4 4 4 4 0 0 4 4 4 4 4 4 0 0 4 4 
0 0 0 0 0 0 0 0 0 0 0 0 0 0 0 0 0 0 0 0 0 0 0 0 0 0 0 0 0 0 0 0 0 0 0 0 0 0 0 0 0 0 0 0 0 0 0 0 0 0 4 4 4 4 4 4 4 4 4 4 4 4 4 4 4 4 4 4 4 4 4 4 0 0 4 4 4 4 4 4 4 4 4 4 4 4 4 4 0 0 4 4 4 4 4 4 0 0 4 4 
0 0 0 0 0 0 0 0 0 0 0 0 0 0 0 0 0 0 0 0 0 0 0 0 0 0 0 0 0 0 0 0 0 0 0 0 0 0 0 0 0 0 0 0 0 0 0 0 0 0 4 4 0 0 0 0 0 0 4 4 0 0 0 0 0 0 0 0 0 0 0 0 0 0 4 4 0 0 0 0 0 0 0 0 0 0 4 4 0 0 4 4 0 0 0 0 0 0 4 4 
0 0 0 0 0 0 0 0 0 0 0 0 0 0 0 0 0 0 0 0 0 0 0 0 0 0 0 0 0 0 0 0 0 0 0 0 0 0 0 0 0 0 0 0 0 0 0 0 0 0 4 4 0 0 0 0 0 0 4 4 0 0 0 0 0 0 0 0 0 0 0 0 0 0 4 4 0 0 0 0 0 0 0 0 0 0 4 4 0 0 4 4 0 0 0 0 0 0 4 4 
0 0 0 0 0 0 0 0 0 0 0 0 0 0 0 0 0 0 0 0 0 0 0 0 0 0 0 0 0 0 0 0 0 0 0 0 0 0 0 0 0 0 0 0 0 0 0 0 0 0 4 4 0 0 4 4 0 0 4 4 0 0 4 4 4 4 4 4 0 0 4 4 4 4 4 4 0 0 4 4 4 4 4 4 0 0 4 4 0 0 4 4 4 4 4 4 0 0 4 4 
0 0 0 0 0 0 0 0 0 0 0 0 0 0 0 0 0 0 0 0 0 0 0 0 0 0 0 0 0 0 0 0 0 0 0 0 0 0 0 0 0 0 0 0 0 0 0 0 0 0 4 4 0 0 4 4 0 0 4 4 0 0 4 4 4 4 4 4 0 0 4 4 4 4 4 4 0 0 4 4 4 4 4 4 0 0 4 4 0 0 4 4 4 4 4 4 0 0 4 4 
0 0 0 0 0 0 0 0 0 0 0 0 0 0 0 0 0 0 0 0 0 0 0 0 0 0 0 0 0 0 0 0 0 0 0 0 0 0 0 0 0 0 0 0 0 0 0 0 0 0 4 4 0 0 4 4 0 0 0 0 0 0 0 0 0 0 4 4 0 0 0 0 0 0 0 0 0 0 0 0 0 0 4 4 0 0 0 0 0 0 0 0 0 0 0 0 0 0 4 4 
0 0 0 0 0 0 0 0 0 0 0 0 0 0 0 0 0 0 0 0 0 0 0 0 0 0 0 0 0 0 0 0 0 0 0 0 0 0 0 0 0 0 0 0 0 0 0 0 0 0 4 4 0 0 4 4 0 0 0 0 0 0 0 0 0 0 4 4 0 0 0 0 0 0 0 0 0 0 0 0 0 0 4 4 0 0 0 0 0 0 0 0 0 0 0 0 0 0 4 4 
0 0 0 0 0 0 0 0 0 0 0 0 0 0 0 0 0 0 0 0 0 0 0 0 0 0 0 0 0 0 0 0 0 0 0 0 0 0 0 0 0 0 0 0 0 0 0 0 0 0 4 4 4 4 4 4 4 4 4 4 4 4 4 4 4 4 4 4 4 4 4 4 4 4 4 4 4 4 4 4 4 4 4 4 4 4 4 4 4 4 4 4 4 4 4 4 4 4 4 4 
0 0 0 0 0 0 0 0 0 0 0 0 0 0 0 0 0 0 0 0 0 0 0 0 0 0 0 0 0 0 0 0 0 0 0 0 0 0 0 0 0 0 0 0 0 0 0 0 0 0 4 4 4 4 4 4 4 4 4 4 4 4 4 4 4 4 4 4 4 4 4 4 4 4 4 4 4 4 4 4 4 4 4 4 4 4 4 4 4 4 4 4 4 4 4 4 4 4 4 4 
